Session,PhoLength,CorLength,Wrong,Correct,Accuracy,Contribution
0,2,3,0,3,1.0,0.0
0,2,4,1,3,0.75,0.05
0,3,5,1,4,0.8,0.0
0,4,4,1,3,0.75,0.0
0,4,4,2,2,0.5,0.0
0,4,5,1,4,0.8,0.0
0,4,6,4,2,0.67,0.0
0,4,6,5,1,0.67,0.05
0,5,5,0,5,1.0,0.0
0,5,5,1,4,0.8,0.0
0,5,5,2,3,0.8,0.0
0,5,5,3,2,0.8,0.05
0,5,6,0,6,1.0,0.0
0,5,6,1,5,0.83,0.0
0,5,6,2,4,0.67,0.0
0,5,6,3,3,0.5,0.05
0,5,6,4,2,0.33,0.0
0,5,6,4,2,0.5,0.0
0,5,7,5,2,0.57,0.0
0,5,7,5,2,0.71,0.05
0,6,6,0,6,1.0,0.0
0,6,6,2,4,0.67,0.0
0,6,6,4,2,0.33,0.0
0,6,7,1,6,0.86,0.0
0,6,8,3,5,0.62,0.0
0,6,9,0,9,1.0,0.05
0,7,6,4,2,0.5,0.0
0,7,7,1,6,0.86,0.05
0,7,8,0,8,1.0,0.0
0,7,8,2,6,0.75,0.0
0,7,8,6,2,0.38,0.0
0,7,9,3,6,0.67,0.0
0,7,9,5,4,0.44,0.0
0,7,9,5,4,0.56,0.05
0,8,8,0,8,1.0,0.0
0,8,8,1,7,0.88,0.0
0,8,8,2,6,0.88,0.0
0,8,8,3,5,0.62,0.0
0,8,8,4,4,0.5,0.0
0,8,8,5,3,0.38,0.05
0,8,9,2,7,0.78,0.05
0,8,9,6,3,0.56,0.0
0,9,9,1,8,0.89,0.0
1,2,3,0,3,1.0,0.0
1,2,4,1,3,0.75,0.0
1,3,5,1,4,0.8,0.0
1,4,4,1,3,0.75,0.0
1,4,4,2,2,0.5,0.0
1,4,5,1,4,0.8,0.0
1,4,6,4,2,0.67,0.0
1,4,6,5,1,0.67,0.0
1,5,5,0,5,1.0,0.0
1,5,5,1,4,0.8,0.0
1,5,5,2,3,0.8,0.07
1,5,5,3,2,0.8,0.0
1,5,6,0,6,1.0,0.0
1,5,6,1,5,0.83,0.0
1,5,6,2,4,0.67,0.0
1,5,6,3,3,0.5,0.0
1,5,6,4,2,0.33,0.0
1,5,6,4,2,0.5,0.0
1,5,7,5,2,0.57,0.0
1,5,7,5,2,0.71,0.0
1,6,6,0,6,1.0,0.0
1,6,6,2,4,0.67,0.07
1,6,6,4,2,0.33,0.07
1,6,7,1,6,0.86,0.07
1,6,7,2,5,0.71,0.07
1,6,8,3,5,0.62,0.07
1,6,9,1,8,0.89,0.07
1,7,6,4,2,0.5,0.0
1,7,7,1,6,0.86,0.07
1,7,8,0,8,1.0,0.0
1,7,8,3,5,0.62,0.0
1,7,8,6,2,0.38,0.07
1,7,9,4,5,0.78,0.0
1,7,9,5,4,0.44,0.0
1,7,9,5,4,0.56,0.0
1,8,8,0,8,1.0,0.0
1,8,8,2,6,0.75,0.0
1,8,8,3,5,0.62,0.0
1,8,8,3,5,0.88,0.0
1,8,8,5,3,0.38,0.0
1,8,9,3,6,0.67,0.0
1,8,9,6,3,0.56,0.0
1,9,9,1,8,0.89,0.07
2,2,3,0,3,1.0,0.0
2,2,4,1,3,0.75,0.0
2,3,5,2,3,0.6,0.0
2,4,4,1,3,0.75,0.0
2,4,4,2,2,0.5,0.0
2,4,5,2,3,0.6,0.0
2,4,6,5,1,0.83,0.0
2,4,6,6,0,0.5,0.0
2,5,5,0,5,1.0,0.0
2,5,5,1,4,0.8,0.0
2,5,5,2,3,0.8,0.0
2,5,5,4,1,0.6,0.0
2,5,6,0,6,1.0,0.0
2,5,6,2,4,0.67,0.0
2,5,6,3,3,0.5,0.0
2,5,6,4,2,0.33,0.0
2,5,6,4,2,0.5,0.0
2,5,6,5,1,0.33,0.1
2,5,7,4,3,0.57,0.0
2,5,7,5,2,0.71,0.0
2,6,6,0,6,1.0,0.0
2,6,6,3,3,0.5,0.0
2,6,6,4,2,0.33,0.1
2,6,7,1,6,0.86,0.0
2,6,7,2,5,0.71,0.0
2,6,8,3,5,0.75,0.0
2,6,9,1,8,0.89,0.0
2,7,6,4,2,0.5,0.0
2,7,7,2,5,0.71,0.0
2,7,7,3,4,0.57,0.0
2,7,8,0,8,1.0,0.1
2,7,8,4,4,0.5,0.1
2,7,8,7,1,0.38,0.1
2,7,9,4,5,0.78,0.0
2,7,9,5,4,0.44,0.0
2,7,9,5,4,0.56,0.0
2,7,9,6,3,0.44,0.0
2,8,8,0,8,1.0,0.0
2,8,8,3,5,0.62,0.1
2,8,8,4,4,0.5,0.0
2,8,8,4,4,0.75,0.0
2,8,8,5,3,0.38,0.0
2,8,8,6,2,0.38,0.0
2,8,9,4,5,0.56,0.0
2,8,9,6,3,0.56,0.0
2,9,9,2,7,0.78,0.0
3,2,3,0,3,1.0,0.0
3,2,4,3,1,0.5,0.0
3,3,5,2,3,0.6,0.0
3,4,4,2,2,0.5,0.1
3,4,5,2,3,0.6,0.1
3,4,6,5,1,0.83,0.0
3,4,6,6,0,0.5,0.0
3,5,5,0,5,1.0,0.0
3,5,5,2,3,0.6,0.0
3,5,5,2,3,0.8,0.0
3,5,5,5,0,0.4,0.1
3,5,6,0,6,1.0,0.1
3,5,6,3,3,0.5,0.0
3,5,6,4,2,0.33,0.0
3,5,6,4,2,0.67,0.0
3,5,6,5,1,0.33,0.0
3,5,7,4,3,0.57,0.0
3,5,7,6,1,0.57,0.0
3,6,6,1,5,0.83,0.0
3,6,6,3,3,0.5,0.0
3,6,6,4,2,0.33,0.0
3,6,7,2,5,0.86,0.14
3,6,7,3,4,0.57,0.0
3,6,8,3,5,0.75,0.0
3,6,9,2,7,0.78,0.0
3,7,6,4,2,0.5,0.0
3,7,7,2,5,0.71,0.14
3,7,7,4,3,0.43,0.0
3,7,8,1,7,0.88,0.0
3,7,8,5,3,0.38,0.0
3,7,8,7,1,0.38,0.0
3,7,9,4,5,0.78,0.0
3,7,9,5,4,0.44,0.0
3,7,9,6,3,0.44,0.0
3,7,9,6,3,0.67,0.14
3,8,8,1,7,0.88,0.14
3,8,8,4,4,0.5,0.0
3,8,8,5,3,0.38,0.14
3,8,8,5,3,0.75,0.0
3,8,8,6,2,0.25,0.0
3,8,8,7,1,0.38,0.0
3,8,9,4,5,0.56,0.0
3,8,9,7,2,0.56,0.14
3,9,9,2,7,0.78,0.0
3,9,9,3,6,0.67,0.0
4,2,3,0,3,1.0,0.0
4,2,4,4,0,0.25,0.0
4,3,5,3,2,0.6,0.0
4,4,4,2,2,0.5,0.14
4,4,5,2,3,0.6,0.0
4,4,6,5,1,0.83,0.14
4,4,6,6,0,0.5,0.0
4,5,5,0,5,1.0,0.0
4,5,5,2,3,0.8,0.0
4,5,5,3,2,0.6,0.14
4,5,5,5,0,0.4,0.0
4,5,6,0,6,1.0,0.0
4,5,6,1,5,0.83,0.0
4,5,6,3,3,0.5,0.0
4,5,6,4,2,0.33,0.0
4,5,6,4,2,0.5,0.0
4,5,6,4,2,0.67,0.14
4,5,6,5,1,0.33,0.0
4,5,7,4,3,0.57,0.0
4,5,7,6,1,0.57,0.0
4,6,6,1,5,0.83,0.0
4,6,6,4,2,0.33,0.0
4,6,7,2,5,0.86,0.0
4,6,7,3,4,0.57,0.0
4,6,8,3,5,0.75,0.0
4,6,9,2,7,0.78,0.0
4,7,6,5,1,0.5,0.11
4,7,7,4,3,0.43,0.0
4,7,7,5,2,0.29,0.0
4,7,8,3,5,0.62,0.0
4,7,8,5,3,0.38,0.0
4,7,8,7,1,0.38,0.0
4,7,9,4,5,0.78,0.0
4,7,9,6,3,0.33,0.11
4,7,9,6,3,0.44,0.11
4,7,9,6,3,0.67,0.0
4,8,8,1,7,0.88,0.0
4,8,8,4,4,0.5,0.0
4,8,8,5,3,0.38,0.0
4,8,8,5,3,0.75,0.0
4,8,8,7,1,0.25,0.11
4,8,8,7,1,0.38,0.0
4,8,9,4,5,0.56,0.0
4,8,9,7,2,0.56,0.11
4,9,9,2,7,0.78,0.0
4,9,9,5,4,0.44,0.0
5,2,3,0,3,1.0,0.0
5,2,4,4,0,0.25,0.0
5,3,5,3,2,0.6,0.0
5,4,4,2,2,0.5,0.0
5,4,5,2,3,0.6,0.0
5,4,6,5,1,0.83,0.0
5,4,6,6,0,0.5,0.0
5,5,5,0,5,1.0,0.0
5,5,5,1,4,0.8,0.11
5,5,5,2,3,0.6,0.11
5,5,5,3,2,0.6,0.0
5,5,5,5,0,0.4,0.0
5,5,6,0,6,1.0,0.0
5,5,6,1,5,0.83,0.11
5,5,6,4,2,0.33,0.0
5,5,6,4,2,0.5,0.0
5,5,6,4,2,0.67,0.0
5,5,6,5,1,0.33,0.11
5,5,7,4,3,0.57,0.0
5,5,7,7,0,0.43,0.0
5,6,6,2,4,0.67,0.0
5,6,6,4,2,0.33,0.11
5,6,7,2,5,0.86,0.0
5,6,7,5,2,0.29,0.0
5,6,8,4,4,0.62,0.0
5,6,9,3,6,0.67,0.0
5,7,6,5,1,0.5,0.0
5,7,7,5,2,0.29,0.13
5,7,7,5,2,0.43,0.0
5,7,8,4,4,0.5,0.0
5,7,8,5,3,0.38,0.13
5,7,8,8,0,0.38,0.0
5,7,9,4,5,0.78,0.0
5,7,9,6,3,0.33,0.13
5,7,9,6,3,0.67,0.0
5,8,8,1,7,0.88,0.13
5,8,8,4,4,0.5,0.0
5,8,8,5,3,0.38,0.13
5,8,8,5,3,0.75,0.0
5,8,8,7,1,0.25,0.0
5,8,8,7,1,0.38,0.0
5,8,9,6,3,0.56,0.13
5,8,9,7,2,0.56,0.0
5,9,9,4,5,0.67,0.0
5,9,9,7,2,0.44,0.13
6,2,3,1,2,0.67,0.0
6,2,4,4,0,0.25,0.0
6,3,5,3,2,0.6,0.0
6,4,4,2,2,0.5,0.0
6,4,5,3,2,0.4,0.0
6,4,6,5,1,0.83,0.0
6,4,6,6,0,0.5,0.13
6,5,5,1,4,0.8,0.0
6,5,5,3,2,0.6,0.0
6,5,5,5,0,0.4,0.0
6,5,6,1,5,0.83,0.0
6,5,6,2,4,0.67,0.0
6,5,6,4,2,0.33,0.0
6,5,6,4,2,0.5,0.0
6,5,6,4,2,0.67,0.13
6,5,6,5,1,0.33,0.0
6,5,6,6,0,0.33,0.0
6,5,7,5,2,0.57,0.0
6,5,7,7,0,0.43,0.13
6,6,6,3,3,0.5,0.0
6,6,6,4,2,0.33,0.0
6,6,7,4,3,0.43,0.0
6,6,7,5,2,0.29,0.0
6,6,8,5,3,0.5,0.0
6,6,9,3,6,0.67,0.0
6,7,6,5,1,0.5,0.0
6,7,7,5,2,0.29,0.0
6,7,7,6,1,0.29,0.0
6,7,8,6,2,0.25,0.0
6,7,8,6,2,0.38,0.0
6,7,8,8,0,0.38,0.0
6,7,9,5,4,0.67,0.0
6,7,9,6,3,0.33,0.15
6,7,9,6,3,0.67,0.0
6,7,9,7,2,0.22,0.0
6,8,8,3,5,0.62,0.15
6,8,8,5,3,0.38,0.0
6,8,8,7,1,0.25,0.0
6,8,8,7,1,0.38,0.15
6,8,8,7,1,0.5,0.0
6,8,9,7,2,0.44,0.0
6,8,9,7,2,0.56,0.0
6,9,9,5,4,0.56,0.15
6,9,9,8,1,0.33,0.0
7,2,3,1,2,0.67,0.0
7,2,4,4,0,0.25,0.0
7,3,5,3,2,0.6,0.0
7,4,4,2,2,0.5,0.0
7,4,4,3,1,0.5,0.15
7,4,5,4,1,0.2,0.15
7,4,6,5,1,0.83,0.0
7,4,6,6,0,0.5,0.0
7,5,5,1,4,0.8,0.0
7,5,5,3,2,0.6,0.0
7,5,5,4,1,0.4,0.0
7,5,5,5,0,0.2,0.0
7,5,6,2,4,0.67,0.15
7,5,6,4,2,0.33,0.0
7,5,6,4,2,0.67,0.0
7,5,6,5,1,0.33,0.0
7,5,6,5,1,0.5,0.0
7,5,6,6,0,0.33,0.0
7,5,7,5,2,0.57,0.0
7,5,7,7,0,0.43,0.0
7,6,6,4,2,0.33,0.15
7,6,6,4,2,0.5,0.0
7,6,7,5,2,0.43,0.15
7,6,7,6,1,0.29,0.0
7,6,8,5,3,0.5,0.15
7,6,9,3,6,0.67,0.0
7,7,6,5,1,0.5,0.0
7,7,7,5,2,0.29,0.0
7,7,7,6,1,0.29,0.0
7,7,8,6,2,0.25,0.0
7,7,8,6,2,0.38,0.0
7,7,8,8,0,0.38,0.0
7,7,9,7,2,0.22,0.0
7,7,9,7,2,0.56,0.0
7,7,9,8,1,0.33,0.0
7,8,8,5,3,0.38,0.0
7,8,8,5,3,0.5,0.0
7,8,8,6,2,0.25,0.0
7,8,8,7,1,0.25,0.16
7,8,8,8,0,0.38,0.0
7,8,8,8,0,0.5,0.0
7,8,9,7,2,0.56,0.16
7,8,9,8,1,0.44,0.0
7,9,9,6,3,0.44,0.0
7,9,9,9,0,0.22,0.16
8,2,3,1,2,0.67,0.0
8,2,4,4,0,0.25,0.0
8,3,5,3,2,0.6,0.0
8,4,4,3,1,0.25,0.16
8,4,4,3,1,0.5,0.0
8,4,5,4,1,0.2,0.16
8,4,6,5,1,0.83,0.16
8,4,6,6,0,0.5,0.0
8,5,5,1,4,0.8,0.0
8,5,5,2,3,0.6,0.16
8,5,5,3,2,0.6,0.16
8,5,5,5,0,0.2,0.0
8,5,6,3,3,0.5,0.0
8,5,6,4,2,0.33,0.0
8,5,6,5,1,0.17,0.0
8,5,6,5,1,0.33,0.0
8,5,6,5,1,0.5,0.0
8,5,6,6,0,0.33,0.0
8,5,7,5,2,0.57,0.0
8,5,7,7,0,0.43,0.0
8,6,6,4,2,0.33,0.0
8,6,6,4,2,0.5,0.0
8,6,7,6,1,0.43,0.0
8,6,7,7,0,0.43,0.0
8,6,8,7,1,0.38,0.0
8,6,9,4,5,0.67,0.0
8,7,6,6,0,0.5,0.0
8,7,7,5,2,0.29,0.16
8,7,7,6,1,0.29,0.0
8,7,8,6,2,0.25,0.16
8,7,8,6,2,0.5,0.0
8,7,8,8,0,0.38,0.0
8,7,9,7,2,0.22,0.0
8,7,9,7,2,0.56,0.0
8,7,9,8,1,0.33,0.0
8,8,8,5,3,0.38,0.0
8,8,8,5,3,0.5,0.0
8,8,8,8,0,0.12,0.0
8,8,8,8,0,0.25,0.0
8,8,8,8,0,0.38,0.0
8,8,8,8,0,0.5,0.0
8,8,9,7,2,0.56,0.0
8,8,9,9,0,0.33,0.0
8,9,9,7,2,0.33,0.19
8,9,9,9,0,0.22,0.0
9,2,3,1,2,0.67,0.0
9,2,4,4,0,0.25,0.19
9,3,5,3,2,0.6,0.0
9,4,4,3,1,0.5,0.0
9,4,4,4,0,0.0,0.19
9,4,5,4,1,0.2,0.0
9,4,6,6,0,0.5,0.0
9,4,6,6,0,0.67,0.0
9,5,5,2,3,0.6,0.19
9,5,5,3,2,0.4,0.19
9,5,5,3,2,0.6,0.0
9,5,5,5,0,0.2,0.19
9,5,6,4,2,0.33,0.0
9,5,6,5,1,0.17,0.0
9,5,6,5,1,0.33,0.19
9,5,6,5,1,0.5,0.0
9,5,6,6,0,0.33,0.0
9,5,7,6,1,0.43,0.0
9,5,7,7,0,0.43,0.0
9,6,6,4,2,0.33,0.0
9,6,6,4,2,0.5,0.0
9,6,7,6,1,0.43,0.0
9,6,7,7,0,0.43,0.0
9,6,8,7,1,0.38,0.0
9,6,9,4,5,0.67,0.0
9,7,6,6,0,0.5,0.0
9,7,7,5,2,0.29,0.0
9,7,7,6,1,0.29,0.0
9,7,8,6,2,0.5,0.0
9,7,8,7,1,0.25,0.0
9,7,8,8,0,0.38,0.19
9,7,9,7,2,0.22,0.19
9,7,9,8,1,0.33,0.0
9,7,9,8,1,0.44,0.0
9,7,9,8,1,0.56,0.19
9,8,8,5,3,0.38,0.0
9,8,8,6,2,0.5,0.0
9,8,8,8,0,0.12,0.0
9,8,8,8,0,0.25,0.0
9,8,8,8,0,0.38,0.0
9,8,8,8,0,0.5,0.0
9,8,9,8,1,0.44,0.0
9,8,9,9,0,0.33,0.0
9,9,9,8,1,0.22,0.0
9,9,9,9,0,0.22,0.0
10,2,3,1,2,0.67,0.0
10,2,4,4,0,0.25,0.0
10,3,5,3,2,0.6,0.0
10,4,4,3,1,0.5,0.0
10,4,4,4,0,0.0,0.0
10,4,5,4,1,0.2,0.18
10,4,6,6,0,0.5,0.18
10,4,6,6,0,0.67,0.0
10,5,5,3,2,0.6,0.0
10,5,5,4,1,0.4,0.18
10,5,5,5,0,0.2,0.0
10,5,6,5,1,0.17,0.0
10,5,6,5,1,0.33,0.0
10,5,6,5,1,0.5,0.18
10,5,6,6,0,0.17,0.18
10,5,6,6,0,0.33,0.0
10,5,7,6,1,0.43,0.0
10,5,7,7,0,0.43,0.0
10,6,6,4,2,0.33,0.18
10,6,6,5,1,0.5,0.0
10,6,7,7,0,0.29,0.0
10,6,7,7,0,0.43,0.0
10,6,8,7,1,0.38,0.0
10,6,9,5,4,0.67,0.0
10,7,6,6,0,0.5,0.0
10,7,7,6,1,0.29,0.0
10,7,8,6,2,0.5,0.0
10,7,8,7,1,0.25,0.0
10,7,8,8,0,0.38,0.0
10,7,9,7,2,0.22,0.0
10,7,9,8,1,0.33,0.0
10,7,9,8,1,0.44,0.18
10,7,9,8,1,0.56,0.0
10,8,8,5,3,0.38,0.0
10,8,8,6,2,0.5,0.0
10,8,8,8,0,0.12,0.18
10,8,8,8,0,0.25,0.0
10,8,8,8,0,0.38,0.0
10,8,8,8,0,0.5,0.0
10,8,9,8,1,0.33,0.18
10,8,9,9,0,0.33,0.18
10,9,9,8,1,0.22,0.0
10,9,9,9,0,0.22,0.0
11,2,3,1,2,0.67,0.0
11,2,4,4,0,0.25,0.0
11,3,5,4,1,0.4,0.0
11,4,4,3,1,0.5,0.0
11,4,4,4,0,0.0,0.0
11,4,5,4,1,0.2,0.0
11,4,6,6,0,0.5,0.0
11,4,6,6,0,0.67,0.0
11,5,5,4,1,0.4,0.0
11,5,5,5,0,0.2,0.0
11,5,6,5,1,0.17,0.0
11,5,6,5,1,0.33,0.0
11,5,6,6,0,0.17,0.16
11,5,6,6,0,0.33,0.16
11,5,7,6,1,0.43,0.0
11,5,7,7,0,0.43,0.0
11,6,6,4,2,0.33,0.16
11,6,6,6,0,0.33,0.0
11,6,7,7,0,0.29,0.0
11,6,7,7,0,0.43,0.0
11,6,8,7,1,0.38,0.16
11,6,9,5,4,0.67,0.16
11,7,6,6,0,0.5,0.0
11,7,7,6,1,0.29,0.0
11,7,7,7,0,0.14,0.0
11,7,8,7,1,0.38,0.16
11,7,8,8,0,0.25,0.0
11,7,8,8,0,0.38,0.0
11,7,9,8,1,0.22,0.0
11,7,9,8,1,0.33,0.0
11,7,9,8,1,0.44,0.0
11,7,9,8,1,0.56,0.0
11,8,8,6,2,0.25,0.0
11,8,8,6,2,0.5,0.0
11,8,8,8,0,0.12,0.0
11,8,8,8,0,0.25,0.0
11,8,8,8,0,0.38,0.0
11,8,8,8,0,0.5,0.0
11,8,9,8,1,0.33,0.16
11,8,9,9,0,0.33,0.0
11,9,9,8,1,0.22,0.0
11,9,9,9,0,0.22,0.0
12,2,3,1,2,0.67,0.16
12,2,4,4,0,0.25,0.0
12,3,5,5,0,0.2,0.0
12,4,4,3,1,0.5,0.0
12,4,4,4,0,0.0,0.16
12,4,5,4,1,0.2,0.0
12,4,6,6,0,0.5,0.0
12,4,6,6,0,0.67,0.0
12,5,5,4,1,0.4,0.16
12,5,5,5,0,0.2,0.0
12,5,5,5,0,0.4,0.0
12,5,6,5,1,0.5,0.0
12,5,6,6,0,0.17,0.0
12,5,6,6,0,0.33,0.0
12,5,7,6,1,0.43,0.0
12,5,7,7,0,0.43,0.0
12,6,6,4,2,0.33,0.0
12,6,6,6,0,0.33,0.0
12,6,7,7,0,0.29,0.16
12,6,7,7,0,0.43,0.0
12,6,8,7,1,0.38,0.0
12,6,9,7,2,0.56,0.0
12,7,6,6,0,0.5,0.16
12,7,7,7,0,0.14,0.16
12,7,8,8,0,0.25,0.0
12,7,8,8,0,0.38,0.0
12,7,9,8,1,0.22,0.16
12,7,9,8,1,0.33,0.0
12,7,9,8,1,0.44,0.0
12,7,9,8,1,0.56,0.0
12,8,8,6,2,0.25,0.0
12,8,8,7,1,0.62,0.0
12,8,8,8,0,0.12,0.0
12,8,8,8,0,0.25,0.0
12,8,8,8,0,0.38,0.0
12,8,8,8,0,0.5,0.0
12,8,9,9,0,0.22,0.0
12,8,9,9,0,0.33,0.16
12,9,9,8,1,0.22,0.0
12,9,9,9,0,0.22,0.16
13,2,3,1,2,0.67,0.16
13,2,4,4,0,0.25,0.0
13,3,5,5,0,0.2,0.0
13,4,4,3,1,0.5,0.0
13,4,4,4,0,0.0,0.0
13,4,5,4,1,0.2,0.0
13,4,6,6,0,0.5,0.0
13,4,6,6,0,0.67,0.0
13,5,5,5,0,0.2,0.0
13,5,5,5,0,0.4,0.16
13,5,6,5,1,0.5,0.0
13,5,6,6,0,0.17,0.0
13,5,6,6,0,0.33,0.0
13,5,7,6,1,0.43,0.0
13,5,7,7,0,0.43,0.0
13,6,6,5,1,0.33,0.0
13,6,6,6,0,0.33,0.0
13,6,7,7,0,0.29,0.16
13,6,7,7,0,0.43,0.0
13,6,8,7,1,0.38,0.0
13,6,9,7,2,0.56,0.0
13,7,6,6,0,0.5,0.0
13,7,7,7,0,0.14,0.0
13,7,8,8,0,0.25,0.16
13,7,8,8,0,0.38,0.0
13,7,9,8,1,0.11,0.0
13,7,9,8,1,0.44,0.0
13,7,9,8,1,0.56,0.0
13,7,9,9,0,0.33,0.0
13,8,8,6,2,0.25,0.0
13,8,8,8,0,0.12,0.16
13,8,8,8,0,0.25,0.16
13,8,8,8,0,0.38,0.0
13,8,8,8,0,0.5,0.0
13,8,9,9,0,0.22,0.16
13,8,9,9,0,0.33,0.0
13,9,9,8,1,0.22,0.0
13,9,9,9,0,0.22,0.0
14,2,3,1,2,0.67,0.16
14,2,4,4,0,0.25,0.0
14,3,5,5,0,0.2,0.16
14,4,4,3,1,0.5,0.16
14,4,4,4,0,0.0,0.0
14,4,5,5,0,0.0,0.16
14,4,6,6,0,0.5,0.0
14,4,6,6,0,0.67,0.0
14,5,5,5,0,0.0,0.0
14,5,5,5,0,0.2,0.0
14,5,5,5,0,0.4,0.0
14,5,6,5,1,0.5,0.0
14,5,6,6,0,0.17,0.0
14,5,6,6,0,0.33,0.0
14,5,7,6,1,0.43,0.0
14,5,7,7,0,0.43,0.0
14,6,6,5,1,0.33,0.0
14,6,6,6,0,0.33,0.0
14,6,7,7,0,0.29,0.0
14,6,7,7,0,0.43,0.0
14,6,8,7,1,0.38,0.0
14,6,9,7,2,0.56,0.0
14,7,6,6,0,0.5,0.16
14,7,7,7,0,0.14,0.0
14,7,8,8,0,0.25,0.0
14,7,9,8,1,0.11,0.0
14,7,9,8,1,0.44,0.16
14,7,9,8,1,0.56,0.0
14,7,9,9,0,0.33,0.0
14,8,8,7,1,0.25,0.0
14,8,8,8,0,0.12,0.16
14,8,8,8,0,0.25,0.0
14,8,8,8,0,0.38,0.0
14,8,8,8,0,0.5,0.0
14,8,9,9,0,0.22,0.0
14,8,9,9,0,0.33,0.0
14,9,9,9,0,0.22,0.0
15,2,3,1,2,0.67,0.0
15,2,4,4,0,0.25,0.0
15,3,5,5,0,0.2,0.0
15,4,4,3,1,0.5,0.15
15,4,4,4,0,0.0,0.0
15,4,5,5,0,0.0,0.15
15,4,6,6,0,0.5,0.15
15,4,6,6,0,0.67,0.0
15,5,5,5,0,0.0,0.0
15,5,5,5,0,0.2,0.0
15,5,5,5,0,0.4,0.0
15,5,6,5,1,0.5,0.0
15,5,6,6,0,0.17,0.0
15,5,6,6,0,0.33,0.15
15,5,7,7,0,0.29,0.0
15,5,7,7,0,0.43,0.15
15,6,6,5,1,0.33,0.15
15,6,6,6,0,0.33,0.0
15,6,7,7,0,0.29,0.0
15,6,7,7,0,0.43,0.0
15,6,8,8,0,0.25,0.0
15,6,9,7,2,0.56,0.15
15,7,6,6,0,0.5,0.0
15,7,7,7,0,0.14,0.0
15,7,8,8,0,0.25,0.0
15,7,9,8,1,0.11,0.0
15,7,9,8,1,0.56,0.0
15,7,9,9,0,0.33,0.0
15,7,9,9,0,0.44,0.0
15,8,8,7,1,0.25,0.0
15,8,8,8,0,0.12,0.0
15,8,8,8,0,0.25,0.0
15,8,8,8,0,0.38,0.0
15,8,8,8,0,0.5,0.0
15,8,9,9,0,0.22,0.0
15,8,9,9,0,0.33,0.15
15,9,9,9,0,0.22,0.0
16,2,3,2,1,0.33,0.0
16,2,4,4,0,0.25,0.0
16,3,5,5,0,0.2,0.15
16,4,4,3,1,0.5,0.0
16,4,4,4,0,0.0,0.0
16,4,5,5,0,0.0,0.0
16,4,6,6,0,0.5,0.15
16,4,6,6,0,0.67,0.0
16,5,5,5,0,0.0,0.0
16,5,5,5,0,0.2,0.0
16,5,5,5,0,0.4,0.0
16,5,6,6,0,0.17,0.0
16,5,6,6,0,0.33,0.0
16,5,7,7,0,0.29,0.0
16,5,7,7,0,0.43,0.0
16,6,6,5,1,0.33,0.0
16,6,6,6,0,0.33,0.16
16,6,7,7,0,0.29,0.0
16,6,7,7,0,0.43,0.16
16,6,8,8,0,0.25,0.16
16,6,9,7,2,0.56,0.0
16,7,6,6,0,0.5,0.0
16,7,7,7,0,0.14,0.0
16,7,8,8,0,0.25,0.0
16,7,9,8,1,0.11,0.0
16,7,9,9,0,0.33,0.0
16,7,9,9,0,0.44,0.16
16,7,9,9,0,0.56,0.0
16,8,8,7,1,0.25,0.16
16,8,8,8,0,0.12,0.16
16,8,8,8,0,0.25,0.0
16,8,8,8,0,0.38,0.0
16,8,8,8,0,0.5,0.0
16,8,9,9,0,0.22,0.0
16,8,9,9,0,0.33,0.16
16,9,9,9,0,0.22,0.0
17,2,3,3,0,0.0,0.0
17,2,4,4,0,0.25,0.0
17,3,5,5,0,0.2,0.0
17,4,4,4,0,0.0,0.0
17,4,4,4,0,0.25,0.0
17,4,5,5,0,0.0,0.0
17,4,6,6,0,0.5,0.0
17,4,6,6,0,0.67,0.0
17,5,5,5,0,0.0,0.0
17,5,5,5,0,0.2,0.0
17,5,5,5,0,0.4,0.0
17,5,6,6,0,0.17,0.0
17,5,6,6,0,0.33,0.16
17,5,7,7,0,0.29,0.0
17,5,7,7,0,0.43,0.0
17,6,6,5,1,0.33,0.0
17,6,6,6,0,0.33,0.16
17,6,7,7,0,0.29,0.0
17,6,7,7,0,0.43,0.0
17,6,8,8,0,0.25,0.0
17,6,9,7,2,0.56,0.16
17,7,6,6,0,0.5,0.0
17,7,7,7,0,0.14,0.0
17,7,8,8,0,0.25,0.0
17,7,9,8,1,0.11,0.0
17,7,9,9,0,0.33,0.0
17,7,9,9,0,0.44,0.0
17,7,9,9,0,0.56,0.0
17,8,8,8,0,0.12,0.0
17,8,8,8,0,0.25,0.0
17,8,8,8,0,0.38,0.17
17,8,8,8,0,0.5,0.0
17,8,9,9,0,0.22,0.17
17,8,9,9,0,0.33,0.0
17,9,9,9,0,0.22,0.0
18,2,3,3,0,0.0,0.0
18,2,4,4,0,0.25,0.0
18,3,5,5,0,0.2,0.0
18,4,4,4,0,0.0,0.0
18,4,4,4,0,0.25,0.0
18,4,5,5,0,0.0,0.17
18,4,6,6,0,0.5,0.0
18,4,6,6,0,0.67,0.0
18,5,5,5,0,0.0,0.17
18,5,5,5,0,0.2,0.0
18,5,5,5,0,0.4,0.0
18,5,6,6,0,0.17,0.0
18,5,6,6,0,0.33,0.0
18,5,7,7,0,0.29,0.17
18,5,7,7,0,0.43,0.0
18,6,6,5,1,0.33,0.0
18,6,6,6,0,0.17,0.0
18,6,6,6,0,0.33,0.0
18,6,7,7,0,0.29,0.0
18,6,7,7,0,0.43,0.0
18,6,8,8,0,0.25,0.0
18,6,9,7,2,0.56,0.0
18,7,6,6,0,0.5,0.0
18,7,7,7,0,0.14,0.0
18,7,8,8,0,0.25,0.0
18,7,9,8,1,0.11,0.0
18,7,9,9,0,0.33,0.0
18,7,9,9,0,0.44,0.17
18,7,9,9,0,0.56,0.17
18,8,8,8,0,0.12,0.0
18,8,8,8,0,0.25,0.0
18,8,8,8,0,0.38,0.17
18,8,8,8,0,0.5,0.17
18,8,9,9,0,0.22,0.0
18,8,9,9,0,0.33,0.0
18,9,9,9,0,0.22,0.17
19,2,3,3,0,0.0,0.0
19,2,4,4,0,0.25,0.0
19,3,5,5,0,0.2,0.0
19,4,4,4,0,0.0,0.0
19,4,4,4,0,0.25,0.0
19,4,5,5,0,0.0,0.0
19,4,6,6,0,0.5,0.0
19,4,6,6,0,0.67,0.0
19,5,5,5,0,0.0,0.0
19,5,5,5,0,0.2,0.18
19,5,5,5,0,0.4,0.0
19,5,6,6,0,0.17,0.18
19,5,6,6,0,0.33,0.0
19,5,7,7,0,0.29,0.0
19,5,7,7,0,0.43,0.0
19,6,6,5,1,0.33,0.0
19,6,6,6,0,0.17,0.0
19,6,6,6,0,0.33,0.0
19,6,7,7,0,0.29,0.0
19,6,7,7,0,0.43,0.18
19,6,8,8,0,0.25,0.0
19,6,9,7,2,0.56,0.0
19,7,6,6,0,0.5,0.18
19,7,7,7,0,0.14,0.0
19,7,8,8,0,0.25,0.0
19,7,9,8,1,0.11,0.0
19,7,9,9,0,0.33,0.0
19,7,9,9,0,0.44,0.18
19,7,9,9,0,0.56,0.0
19,8,8,8,0,0.12,0.0
19,8,8,8,0,0.25,0.0
19,8,8,8,0,0.38,0.0
19,8,8,8,0,0.5,0.0
19,8,9,9,0,0.22,0.0
19,8,9,9,0,0.33,0.0
19,9,9,9,0,0.22,0.0
20,2,3,3,0,0.0,0.0
20,2,4,4,0,0.25,0.0
20,3,5,5,0,0.2,0.0
20,4,4,4,0,0.0,0.0
20,4,4,4,0,0.25,0.0
20,4,5,5,0,0.0,0.18
20,4,6,6,0,0.5,0.18
20,4,6,6,0,0.67,0.0
20,5,5,5,0,0.0,0.0
20,5,5,5,0,0.2,0.18
20,5,5,5,0,0.4,0.18
20,5,6,6,0,0.17,0.0
20,5,6,6,0,0.33,0.0
20,5,7,7,0,0.29,0.18
20,5,7,7,0,0.43,0.0
20,6,6,5,1,0.33,0.0
20,6,6,6,0,0.17,0.0
20,6,6,6,0,0.33,0.0
20,6,7,7,0,0.29,0.0
20,6,7,7,0,0.43,0.0
20,6,8,8,0,0.25,0.0
20,6,9,7,2,0.56,0.0
20,7,6,6,0,0.5,0.0
20,7,7,7,0,0.14,0.21
20,7,8,8,0,0.25,0.0
20,7,9,8,1,0.11,0.21
20,7,9,9,0,0.33,0.0
20,7,9,9,0,0.44,0.0
20,7,9,9,0,0.56,0.0
20,8,8,8,0,0.12,0.0
20,8,8,8,0,0.25,0.0
20,8,8,8,0,0.38,0.0
20,8,8,8,0,0.5,0.0
20,8,9,9,0,0.22,0.21
20,8,9,9,0,0.33,0.0
20,9,9,9,0,0.22,0.0
21,2,3,3,0,0.0,0.21
21,2,4,4,0,0.25,0.0
21,3,5,5,0,0.2,0.0
21,4,4,4,0,0.0,0.0
21,4,4,4,0,0.25,0.0
21,4,5,5,0,0.0,0.0
21,4,6,6,0,0.5,0.0
21,4,6,6,0,0.67,0.0
21,5,5,5,0,0.0,0.0
21,5,5,5,0,0.2,0.0
21,5,5,5,0,0.4,0.0
21,5,6,6,0,0.17,0.0
21,5,6,6,0,0.33,0.0
21,5,7,7,0,0.29,0.0
21,5,7,7,0,0.43,0.0
21,6,6,5,1,0.33,0.0
21,6,6,6,0,0.17,0.0
21,6,6,6,0,0.33,0.0
21,6,7,7,0,0.29,0.0
21,6,7,7,0,0.43,0.21
21,6,8,8,0,0.25,0.21
21,6,9,7,2,0.56,0.0
21,7,6,6,0,0.5,0.0
21,7,7,7,0,0.14,0.21
21,7,8,8,0,0.25,0.21
21,7,9,8,1,0.11,0.0
21,7,9,9,0,0.33,0.0
21,7,9,9,0,0.44,0.21
21,7,9,9,0,0.56,0.0
21,8,8,8,0,0.12,0.0
21,8,8,8,0,0.25,0.0
21,8,8,8,0,0.38,0.0
21,8,8,8,0,0.5,0.0
21,8,9,9,0,0.22,0.0
21,8,9,9,0,0.33,0.21
21,9,9,9,0,0.22,0.0
22,2,3,3,0,0.0,0.0
22,2,4,4,0,0.25,0.2
22,3,5,5,0,0.2,0.0
22,4,4,4,0,0.0,0.2
22,4,4,4,0,0.25,0.0
22,4,5,5,0,0.0,0.0
22,4,6,6,0,0.5,0.0
22,4,6,6,0,0.67,0.0
22,5,5,5,0,0.0,0.0
22,5,5,5,0,0.2,0.0
22,5,5,5,0,0.4,0.0
22,5,6,6,0,0.17,0.2
22,5,6,6,0,0.33,0.0
22,5,7,7,0,0.29,0.2
22,5,7,7,0,0.43,0.0
22,6,6,6,0,0.17,0.0
22,6,6,6,0,0.33,0.0
22,6,7,7,0,0.29,0.0
22,6,7,7,0,0.43,0.0
22,6,8,8,0,0.25,0.0
22,6,9,7,2,0.56,0.0
22,7,6,6,0,0.5,0.0
22,7,7,7,0,0.14,0.0
22,7,8,8,0,0.25,0.0
22,7,9,8,1,0.11,0.0
22,7,9,9,0,0.33,0.0
22,7,9,9,0,0.44,0.0
22,7,9,9,0,0.56,0.0
22,8,8,8,0,0.12,0.0
22,8,8,8,0,0.25,0.0
22,8,8,8,0,0.38,0.0
22,8,8,8,0,0.5,0.0
22,8,9,9,0,0.22,0.0
22,8,9,9,0,0.33,0.2
22,9,9,9,0,0.22,0.2
23,2,3,3,0,0.0,0.0
23,2,4,4,0,0.25,0.0
23,3,5,5,0,0.2,0.2
23,4,4,4,0,0.0,0.2
23,4,4,4,0,0.25,0.0
23,4,5,5,0,0.0,0.0
23,4,6,6,0,0.5,0.2
23,4,6,6,0,0.67,0.0
23,5,5,5,0,0.0,0.0
23,5,5,5,0,0.2,0.0
23,5,5,5,0,0.4,0.0
23,5,6,6,0,0.17,0.0
23,5,6,6,0,0.33,0.0
23,5,7,7,0,0.29,0.2
23,5,7,7,0,0.43,0.0
23,6,6,6,0,0.17,0.0
23,6,6,6,0,0.33,0.19
23,6,7,7,0,0.29,0.0
23,6,7,7,0,0.43,0.19
23,6,8,8,0,0.25,0.0
23,6,9,7,2,0.56,0.0
23,7,6,6,0,0.5,0.0
23,7,7,7,0,0.14,0.0
23,7,8,8,0,0.25,0.0
23,7,9,8,1,0.11,0.0
23,7,9,9,0,0.33,0.0
23,7,9,9,0,0.44,0.19
23,7,9,9,0,0.56,0.0
23,8,8,8,0,0.12,0.19
23,8,8,8,0,0.25,0.0
23,8,8,8,0,0.38,0.0
23,8,8,8,0,0.5,0.0
23,8,9,9,0,0.22,0.0
23,8,9,9,0,0.33,0.0
23,9,9,9,0,0.22,0.0
24,2,3,3,0,0.0,0.0
24,2,4,4,0,0.25,0.0
24,3,5,5,0,0.2,0.0
24,4,4,4,0,0.0,0.0
24,4,4,4,0,0.25,0.0
24,4,5,5,0,0.0,0.0
24,4,6,6,0,0.5,0.0
24,4,6,6,0,0.67,0.0
24,5,5,5,0,0.0,0.0
24,5,5,5,0,0.2,0.0
24,5,5,5,0,0.4,0.0
24,5,6,6,0,0.17,0.0
24,5,6,6,0,0.33,0.0
24,5,7,7,0,0.29,0.19
24,5,7,7,0,0.43,0.19
24,6,6,6,0,0.17,0.0
24,6,6,6,0,0.33,0.0
24,6,7,7,0,0.29,0.19
24,6,7,7,0,0.43,0.19
24,6,8,8,0,0.25,0.0
24,6,9,7,2,0.56,0.0
24,7,6,6,0,0.5,0.19
24,7,7,7,0,0.14,0.0
24,7,8,8,0,0.25,0.0
24,7,9,8,1,0.11,0.0
24,7,9,9,0,0.33,0.0
24,7,9,9,0,0.44,0.0
24,7,9,9,0,0.56,0.0
24,8,8,8,0,0.12,0.19
24,8,8,8,0,0.25,0.0
24,8,8,8,0,0.38,0.0
24,8,8,8,0,0.5,0.2
24,8,9,9,0,0.22,0.0
24,8,9,9,0,0.33,0.2
24,9,9,9,0,0.22,0.0
25,2,3,3,0,0.0,0.0
25,2,4,4,0,0.25,0.0
25,3,5,5,0,0.2,0.0
25,4,4,4,0,0.0,0.0
25,4,4,4,0,0.25,0.0
25,4,5,5,0,0.0,0.0
25,4,6,6,0,0.5,0.2
25,4,6,6,0,0.67,0.0
25,5,5,5,0,0.0,0.2
25,5,5,5,0,0.2,0.0
25,5,5,5,0,0.4,0.0
25,5,6,6,0,0.17,0.0
25,5,6,6,0,0.33,0.0
25,5,7,7,0,0.29,0.0
25,5,7,7,0,0.43,0.0
25,6,6,6,0,0.17,0.0
25,6,6,6,0,0.33,0.0
25,6,7,7,0,0.29,0.0
25,6,7,7,0,0.43,0.0
25,6,8,8,0,0.25,0.0
25,6,9,7,2,0.56,0.0
25,7,6,6,0,0.5,0.0
25,7,7,7,0,0.14,0.0
25,7,8,8,0,0.25,0.0
25,7,9,8,1,0.11,0.0
25,7,9,9,0,0.33,0.0
25,7,9,9,0,0.44,0.0
25,7,9,9,0,0.56,0.0
25,8,8,8,0,0.12,0.2
25,8,8,8,0,0.25,0.2
25,8,8,8,0,0.38,0.0
25,8,8,8,0,0.5,0.0
25,8,9,9,0,0.22,0.2
25,8,9,9,0,0.33,0.2
25,9,9,9,0,0.22,0.0
26,2,3,3,0,0.0,0.0
26,2,4,4,0,0.25,0.2
26,3,5,5,0,0.2,0.0
26,4,4,4,0,0.0,0.0
26,4,4,4,0,0.25,0.0
26,4,5,5,0,0.0,0.0
26,4,6,6,0,0.5,0.0
26,4,6,6,0,0.67,0.0
26,5,5,5,0,0.0,0.2
26,5,5,5,0,0.2,0.0
26,5,5,5,0,0.4,0.0
26,5,6,6,0,0.17,0.19
26,5,6,6,0,0.33,0.0
26,5,7,7,0,0.29,0.19
26,5,7,7,0,0.43,0.0
26,6,6,6,0,0.17,0.0
26,6,6,6,0,0.33,0.0
26,6,7,7,0,0.29,0.0
26,6,7,7,0,0.43,0.0
26,6,8,8,0,0.25,0.0
26,6,9,7,2,0.56,0.0
26,7,6,6,0,0.5,0.19
26,7,7,7,0,0.14,0.0
26,7,8,8,0,0.25,0.19
26,7,9,8,1,0.11,0.0
26,7,9,9,0,0.33,0.0
26,7,9,9,0,0.44,0.0
26,7,9,9,0,0.56,0.0
26,8,8,8,0,0.12,0.0
26,8,8,8,0,0.25,0.0
26,8,8,8,0,0.38,0.0
26,8,8,8,0,0.5,0.0
26,8,9,9,0,0.22,0.0
26,8,9,9,0,0.33,0.0
26,9,9,9,0,0.22,0.0
27,2,3,3,0,0.0,0.0
27,2,4,4,0,0.25,0.0
27,3,5,5,0,0.2,0.0
27,4,4,4,0,0.0,0.0
27,4,4,4,0,0.25,0.0
27,4,5,5,0,0.0,0.0
27,4,6,6,0,0.5,0.0
27,4,6,6,0,0.67,0.0
27,5,5,5,0,0.0,0.19
27,5,5,5,0,0.2,0.19
27,5,5,5,0,0.4,0.0
27,5,6,6,0,0.17,0.0
27,5,6,6,0,0.33,0.19
27,5,7,7,0,0.29,0.19
27,5,7,7,0,0.43,0.0
27,6,6,6,0,0.17,0.0
27,6,6,6,0,0.33,0.19
27,6,7,7,0,0.29,0.0
27,6,7,7,0,0.43,0.0
27,6,8,8,0,0.25,0.0
27,6,9,7,2,0.56,0.0
27,7,6,6,0,0.5,0.0
27,7,7,7,0,0.14,0.0
27,7,8,8,0,0.25,0.19
27,7,9,8,1,0.11,0.0
27,7,9,9,0,0.33,0.0
27,7,9,9,0,0.44,0.18
27,7,9,9,0,0.56,0.0
27,8,8,8,0,0.12,0.18
27,8,8,8,0,0.25,0.0
27,8,8,8,0,0.38,0.0
27,8,8,8,0,0.5,0.0
27,8,9,9,0,0.22,0.0
27,8,9,9,0,0.33,0.0
27,9,9,9,0,0.22,0.0
28,2,3,3,0,0.0,0.0
28,2,4,4,0,0.25,0.18
28,3,5,5,0,0.2,0.0
28,4,4,4,0,0.0,0.18
28,4,4,4,0,0.25,0.0
28,4,5,5,0,0.0,0.0
28,4,6,6,0,0.5,0.0
28,4,6,6,0,0.67,0.0
28,5,5,5,0,0.0,0.0
28,5,5,5,0,0.2,0.0
28,5,5,5,0,0.4,0.0
28,5,6,6,0,0.17,0.0
28,5,6,6,0,0.33,0.0
28,5,7,7,0,0.29,0.0
28,5,7,7,0,0.43,0.0
28,6,6,6,0,0.17,0.0
28,6,6,6,0,0.33,0.0
28,6,7,7,0,0.29,0.0
28,6,7,7,0,0.43,0.0
28,6,8,8,0,0.25,0.0
28,6,9,7,2,0.56,0.0
28,7,6,6,0,0.5,0.0
28,7,7,7,0,0.14,0.0
28,7,8,8,0,0.25,0.18
28,7,9,8,1,0.11,0.18
28,7,9,9,0,0.33,0.0
28,7,9,9,0,0.44,0.0
28,7,9,9,0,0.56,0.18
28,8,8,8,0,0.12,0.18
28,8,8,8,0,0.25,0.0
28,8,8,8,0,0.38,0.0
28,8,8,8,0,0.5,0.18
28,8,9,9,0,0.22,0.0
28,8,9,9,0,0.33,0.0
28,9,9,9,0,0.22,0.0
29,2,3,3,0,0.0,0.0
29,2,4,4,0,0.25,0.0
29,3,5,5,0,0.2,0.0
29,4,4,4,0,0.0,0.18
29,4,4,4,0,0.25,0.0
29,4,5,5,0,0.0,0.0
29,4,6,6,0,0.5,0.17
29,4,6,6,0,0.67,0.0
29,5,5,5,0,0.0,0.17
29,5,5,5,0,0.2,0.0
29,5,5,5,0,0.4,0.0
29,5,6,6,0,0.17,0.0
29,5,6,6,0,0.33,0.0
29,5,7,7,0,0.29,0.0
29,5,7,7,0,0.43,0.0
29,6,6,6,0,0.17,0.0
29,6,6,6,0,0.33,0.17
29,6,7,7,0,0.29,0.0
29,6,7,7,0,0.43,0.17
29,6,8,8,0,0.25,0.0
29,6,9,7,2,0.56,0.0
29,7,6,6,0,0.5,0.0
29,7,7,7,0,0.14,0.0
29,7,8,8,0,0.25,0.0
29,7,9,8,1,0.11,0.0
29,7,9,9,0,0.33,0.0
29,7,9,9,0,0.44,0.0
29,7,9,9,0,0.56,0.0
29,8,8,8,0,0.12,0.0
29,8,8,8,0,0.25,0.0
29,8,8,8,0,0.38,0.0
29,8,8,8,0,0.5,0.0
29,8,9,9,0,0.22,0.0
29,8,9,9,0,0.33,0.0
29,9,9,9,0,0.22,0.0
